####
#.##
#  ###
#*@ ##
#  $ #
#    #
######