 ####
 #  ###
 #$   #
##@$. #
# $#.##
#   .#
#    #
#    #
######